256 256 256 256 256 256 256 256 256 256 256 256 256 256 256 256 256 256 159 164 158 164 158 164 158 164 158 164 158 164 158 166 256 256 256 256 256 256 256 256 256 256 256 256 256 256 256 256 256 256 
256 256 256 256 256 256 256 256 256 256 256 256 256 256 256 256 256 165 157 150 153 150 153 150 153 150 153 150 153 150 153 162 160 256 256 256 256 256 256 256 256 256 256 256 256 256 256 256 256 256 
256 256 256 256 256 256 256 256 256 256 256 256 256 256 256 256 159 163 153 149 152 149 152 149 152 149 152 149 152 149 152 150 156 166 256 256 256 256 256 256 256 256 256 256 256 256 256 256 256 256 
256 256 256 256 256 256 256 256 256 256 256 256 256 256 256 165 157 150 152 149 152 149 152 149 152 149 152 149 152 149 152 149 153 162 160 256 256 256 256 256 256 256 256 256 256 256 256 256 256 256 
256 256 256 256 256 256 256 256 256 256 256 256 256 256 159 163 153 149 152 148 151 148 151 148 151 148 151 148 151 148 151 149 152 150 156 166 256 256 256 256 256 256 256 256 256 256 256 256 256 256 
256 256 256 256 256 256 256 256 256 256 256 256 256 165 157 150 152 149 151 301 300 300 300 300 300 300 300 300 300 300 303 148 152 149 153 162 160 256 256 256 256 256 256 256 256 256 256 256 256 256 
256 256 256 256 256 256 256 256 256 256 256 256 159 163 153 149 152 148 301 302 301 300 300 300 300 300 300 300 300 303 304 303 151 149 152 150 156 166 256 256 256 256 256 256 256 256 256 256 256 256 
256 256 256 256 256 256 256 256 256 256 256 165 157 150 152 149 151 301 302 301 302 154 154 154 154 154 154 154 154 304 303 304 303 148 152 149 153 162 160 256 256 256 256 256 256 256 256 256 256 256 
256 256 256 256 256 256 256 256 256 256 159 163 153 149 152 148 301 302 301 302 154 154 154 154 154 154 154 154 154 154 304 303 304 303 151 149 152 150 156 166 256 256 256 256 256 256 256 256 256 256 
256 256 256 256 256 256 256 256 256 165 157 150 152 149 151 301 302 301 302 154 154 154 154 154 154 154 154 154 154 154 154 304 303 304 303 148 152 149 153 162 160 256 256 256 256 256 256 256 256 256 
256 256 256 256 256 256 256 256 256 161 153 149 152 148 301 302 301 302 154 154 154 154 154 154 154 154 154 154 154 154 154 154 304 303 304 303 151 149 152 150 167 256 256 256 256 256 256 256 256 256 
256 256 256 256 256 256 256 256 256 167 152 149 151 301 302 301 302 154 154 154 154 154 154 154 154 154 154 154 154 154 154 154 154 304 303 304 303 148 152 149 161 256 256 256 256 256 256 256 256 256 
256 256 256 256 256 256 256 256 256 161 152 148 301 302 301 302 154 154 154 154 154 154 154 154 154 154 154 154 154 154 154 154 154 154 304 303 304 303 151 149 167 256 256 256 256 256 256 256 256 256 
256 256 256 256 256 256 256 256 256 167 151 301 302 301 302 154 154 154 154 154 154 154 154 154 154 154 154 154 154 154 154 154 154 154 154 304 303 304 303 148 161 256 256 256 256 256 256 256 256 256 
256 256 256 256 256 256 256 256 256 161 301 302 301 302 154 154 154 154 154 154 154 154 154 154 154 154 154 154 154 154 154 154 154 154 154 154 304 303 304 303 167 256 256 256 256 256 256 256 256 256 
256 256 256 256 256 256 256 256 256 167 298 301 302 154 154 154 154 154 154 154 154 154 154 154 154 154 154 154 154 154 154 154 154 154 154 154 154 304 303 299 161 256 256 256 256 256 256 256 256 256
256 256 256 256 256 256 256 256 256 161 298 298 154 154 154 154 154 154 154 154 154 154 154 154 154 154 154 154 154 154 154 154 154 154 154 154 154 154 299 299 167 256 256 256 256 256 256 256 256 256
256 256 256 256 256 256 256 256 256 167 298 298 154 154 154 154 154 154 154 154 154 154 154 154 154 154 154 154 154 154 154 154 154 154 154 154 154 154 299 299 161 256 256 256 256 256 256 256 256 256
256 256 256 256 256 256 256 256 256 161 298 298 154 154 154 154 154 154 154 154 154 154 154 154 154 154 154 154 154 154 154 154 154 154 154 154 154 154 299 299 167 256 256 256 256 256 256 256 256 256
256 256 256 256 256 256 256 256 256 167 298 298 154 154 154 154 154 154 154 154 154 154 154 154 154 154 154 154 154 154 154 154 154 154 154 154 154 154 299 299 161 256 256 256 256 256 256 256 256 256
256 256 256 256 256 256 256 256 256 161 298 294 295 154 154 154 154 154 154 154 154 154 154 154 154 154 154 154 154 154 154 154 154 154 154 154 154 296 297 299 167 256 256 256 256 256 256 256 256 256
256 256 256 256 256 256 256 256 256 161 294 295 294 295 154 154 154 154 154 154 154 154 154 154 154 154 154 154 154 154 154 154 154 154 154 154 296 297 296 297 161 256 256 256 256 256 256 256 256 256 
256 256 256 256 256 256 256 256 256 156 166 294 295 294 295 154 154 154 154 154 154 154 154 154 154 154 154 154 154 154 154 154 154 154 154 296 297 296 297 159 163 256 256 256 256 256 256 256 256 256 
256 256 256 256 256 256 256 256 256 153 162 160 294 295 294 295 154 154 154 154 154 154 154 154 154 154 154 154 154 154 154 154 154 154 296 297 296 297 165 157 150 256 256 256 256 256 256 256 256 256 
256 256 256 256 256 256 256 256 256 152 150 156 166 294 295 294 295 154 154 154 154 154 154 154 154 154 154 154 154 154 154 154 154 296 297 296 297 159 163 153 149 256 256 256 256 256 256 256 256 256 
256 256 256 256 256 256 256 256 256 152 149 153 162 160 294 295 294 295 154 154 154 154 154 154 154 154 154 154 154 154 154 154 296 297 296 297 165 157 150 152 149 256 256 256 256 256 256 256 256 256 
256 256 256 256 256 256 256 256 256 151 149 152 150 156 166 294 295 294 295 154 154 154 154 154 154 154 154 154 154 154 154 296 297 296 297 159 163 153 149 152 148 256 256 256 256 256 256 256 256 256 
256 256 256 256 256 256 256 256 256 256 148 152 149 153 162 160 294 295 294 295 154 154 154 154 154 154 154 154 154 154 296 297 296 297 165 157 150 152 149 151 256 256 256 256 256 256 256 256 256 256 
256 256 256 256 256 256 256 256 256 256 256 151 149 152 150 156 166 294 295 294 295 154 154 154 154 154 154 154 154 296 297 296 297 159 163 153 149 152 148 256 256 256 256 256 256 256 256 256 256 256 
256 256 256 256 256 256 256 256 256 256 256 256 148 152 149 153 162 160 294 295 294 293 293 293 293 293 293 293 293 297 296 297 165 157 150 152 149 151 256 256 256 256 256 256 256 256 256 256 256 256 
256 256 256 256 256 256 256 256 256 256 256 256 256 151 149 152 150 156 166 294 293 293 293 293 293 293 293 293 293 293 297 159 163 153 149 152 148 256 256 256 256 256 256 256 256 256 256 256 256 256 
256 256 256 256 256 256 256 256 256 256 256 256 256 256 148 152 149 153 162 158 164 158 164 158 164 158 164 158 164 158 164 157 150 152 149 151 256 256 256 256 256 256 256 256 256 256 256 256 256 256 
256 256 256 256 256 256 256 256 256 256 256 256 256 256 256 151 149 152 150 153 150 153 150 153 150 153 150 153 150 153 150 153 149 152 148 256 256 256 256 256 256 256 256 256 256 256 256 256 256 256 
256 256 256 256 256 256 256 256 256 256 256 256 256 256 256 256 148 152 149 152 149 152 149 152 149 152 149 152 149 152 149 152 149 151 256 256 256 256 256 256 256 256 256 256 256 256 256 256 256 256 
256 256 256 256 256 256 256 256 256 256 256 256 256 256 256 256 256 151 149 152 149 152 149 152 149 152 149 152 149 152 149 152 148 256 256 256 256 256 256 256 256 256 256 256 256 256 256 256 256 256 
256 256 256 256 256 256 256 256 256 256 256 256 256 256 256 256 256 256 148 151 148 151 148 151 148 151 148 151 148 151 148 151 256 256 256 256 256 256 256 256 256 256 256 256 256 256 256 256 256 256 
256 256 256 256 256 256 256 256 256 256 256 256 256 256 256 256 256 256 256 256 256 256 256 256 256 256 256 256 256 256 256 256 256 256 256 256 256 256 256 256 256 256 256 256 256 256 256 256 256 256 
256 256 256 256 256 256 256 256 256 256 256 256 256 256 256 256 256 256 256 256 256 256 256 256 256 256 256 256 256 256 256 256 256 256 256 256 256 256 256 256 256 256 256 256 256 256 256 256 256 256 
256 256 256 256 256 256 256 256 256 256 256 256 256 256 256 256 256 256 256 256 256 256 256 256 256 256 256 256 256 256 256 256 256 256 256 256 256 256 256 256 256 256 256 256 256 256 256 256 256 256 
256 256 256 256 256 256 256 256 256 256 256 256 256 256 256 256 256 256 256 256 256 256 256 256 256 256 256 256 256 256 256 256 256 256 256 256 256 256 256 256 256 256 256 256 256 256 256 256 256 256 
256 256 256 256 256 256 256 256 256 256 256 256 256 256 256 256 256 256 256 256 256 256 256 256 256 256 256 256 256 256 256 256 256 256 256 256 256 256 256 256 256 256 256 256 256 256 256 256 256 256 
256 256 256 256 256 256 256 256 256 256 256 256 256 256 256 256 256 256 256 256 256 256 256 256 256 256 256 256 256 256 256 256 256 256 256 256 256 256 256 256 256 256 256 256 256 256 256 256 256 256 
256 256 256 256 256 256 256 256 256 256 256 256 256 256 256 256 256 256 256 256 256 256 256 256 256 256 256 256 256 256 256 256 256 256 256 256 256 256 256 256 256 256 256 256 256 256 256 256 256 256 
256 256 256 256 256 256 256 256 256 256 256 256 256 256 256 256 256 256 256 256 256 256 256 256 256 256 256 256 256 256 256 256 256 256 256 256 256 256 256 256 256 256 256 256 256 256 256 256 256 256 
256 256 256 256 256 256 256 256 256 256 256 256 256 256 256 256 256 256 256 256 256 256 256 256 256 256 256 256 256 256 256 256 256 256 256 256 256 256 256 256 256 256 256 256 256 256 256 256 256 256 
256 256 256 256 256 256 256 256 256 256 256 256 256 256 256 256 256 256 256 256 256 256 256 256 256 256 256 256 256 256 256 256 256 256 256 256 256 256 256 256 256 256 256 256 256 256 256 256 256 256 
256 256 256 256 256 256 256 256 256 256 256 256 256 256 256 256 256 256 256 256 256 256 256 256 256 256 256 256 256 256 256 256 256 256 256 256 256 256 256 256 256 256 256 256 256 256 256 256 256 256 
256 256 256 256 256 256 256 256 256 256 256 256 256 256 256 256 256 256 256 256 256 256 256 256 256 256 256 256 256 256 256 256 256 256 256 256 256 256 256 256 256 256 256 256 256 256 256 256 256 256 
256 256 256 256 256 256 256 256 256 256 256 256 256 256 256 256 256 256 256 256 256 256 256 256 256 256 256 256 256 256 256 256 256 256 256 256 256 256 256 256 256 256 256 256 256 256 256 256 256 256 
256 256 256 256 256 256 256 256 256 256 256 256 256 256 256 256 256 256 256 256 256 256 256 256 256 256 256 256 256 256 256 256 256 256 256 256 256 256 256 256 256 256 256 256 256 256 256 256 256 256 
