159 158 158 158 158 158 160 256 256 256 256 256 256 256 256 256 256 256 256 256 256 256 256 256 256 256 159 158 158 158 158 158 158 158 158 158 160 256 256 256 256 256 256 256 256 256 256 256 256 256
161 426 425 425 425 427 161 256 256 256 256 256 256 256 256 256 256 256 256 256 159 158 158 158 158 158 157 426 425 425 425 425 425 425 425 427 156 158 160 256 256 256 256 256 256 256 256 256 256 256
161 422 423 423 423 424 161 256 256 159 158 158 158 158 158 160 256 256 256 159 157 426 425 425 425 425 425 417 423 423 423 423 423 423 423 418 425 427 156 158 160 256 256 256 256 256 256 256 256 256
161 422 423 423 423 424 161 256 159 157 426 425 425 425 427 156 158 158 158 157 426 417 423 423 423 423 423 423 423 423 423 423 423 423 423 423 423 418 425 427 161 256 256 256 256 256 256 256 256 256
161 422 423 423 423 424 161 256 161 426 417 423 423 423 418 425 425 425 425 425 417 423 423 423 423 423 423 423 423 423 423 423 423 423 423 423 423 423 423 424 161 256 256 256 256 256 256 256 256 256
161 422 423 423 423 424 161 256 161 422 423 423 423 423 423 423 423 423 423 423 423 423 423 423 423 423 423 423 423 423 423 423 423 423 423 423 423 423 423 424 161 256 256 256 256 256 256 256 256 256
161 422 423 423 423 424 161 256 161 422 423 423 423 423 423 423 423 423 423 423 423 423 423 423 423 423 423 423 423 423 423 423 423 423 423 423 423 423 423 424 161 256 256 256 256 256 256 256 256 256
161 422 423 423 423 424 156 160 161 422 423 423 423 423 423 423 423 423 423 423 423 423 423 423 423 423 423 423 423 423 423 423 423 423 423 423 423 423 423 424 156 160 256 256 256 256 256 256 256 256
161 422 423 423 423 418 427 161 161 422 423 423 423 423 423 423 423 423 423 423 423 423 423 423 423 423 423 423 423 423 423 423 423 423 423 423 423 423 423 418 427 161 256 256 256 256 256 256 256 256
161 422 423 423 423 423 424 161 161 422 423 423 423 423 159 158 158 158 158 158 158 160 423 423 423 423 159 158 158 158 158 158 158 160 423 423 423 423 423 423 424 161 256 256 256 256 256 256 256 256
161 422 423 423 423 423 424 161 161 422 423 423 423 423 161 256 256 256 256 256 256 161 423 423 423 423 161 256 256 256 256 256 256 161 423 423 423 423 423 423 424 161 256 256 256 256 256 256 256 256
161 422 423 423 423 423 424 161 161 422 423 423 423 423 161 256 256 256 256 256 256 161 423 423 423 423 161 256 256 256 256 256 256 161 423 423 423 423 423 423 424 161 256 256 256 256 256 256 256 256
161 422 423 423 423 423 424 161 161 422 423 423 423 423 161 256 256 158 158 158 158 157 423 423 423 423 156 158 158 158 158 256 256 161 423 423 423 423 423 423 424 161 256 256 256 256 256 256 256 256
161 422 423 423 423 423 424 161 161 422 423 423 423 423 161 256 256 161 423 423 423 423 423 423 423 423 423 423 423 423 161 256 256 161 423 423 423 423 423 423 424 161 256 256 256 256 256 256 256 256
161 422 423 423 423 416 421 161 161 422 423 423 423 423 161 256 256 161 423 423 423 423 423 423 423 423 423 423 423 423 161 256 256 161 423 423 423 423 423 423 424 161 256 256 256 256 256 256 256 256
161 422 423 423 423 424 159 157 161 422 423 423 423 423 161 256 256 161 423 423 423 423 423 423 423 423 423 423 423 423 161 256 256 161 423 423 423 423 423 423 424 161 256 256 256 256 256 256 256 256
161 422 423 423 423 424 161 256 161 422 423 423 423 423 156 158 158 157 423 423 423 423 423 423 423 423 423 423 423 423 156 158 158 157 423 423 423 423 423 423 424 161 256 256 256 256 256 256 256 256
161 422 423 423 423 424 161 256 161 422 423 423 423 423 423 423 423 423 423 423 423 423 423 423 423 423 423 423 423 423 423 423 423 423 423 423 423 423 423 423 424 161 256 256 256 256 256 256 256 256
161 422 423 423 423 424 161 256 161 422 423 423 423 423 423 423 423 423 423 423 423 423 423 423 423 423 423 423 423 423 423 423 423 423 423 423 423 423 423 423 424 161 256 256 256 256 256 256 256 256
161 422 423 423 423 424 161 256 161 422 423 423 423 423 423 423 423 423 423 423 423 423 423 423 423 423 423 423 423 423 423 423 423 423 423 423 423 423 423 423 424 161 256 256 256 256 256 256 256 256
161 422 423 423 423 424 161 159 157 422 423 423 423 423 423 423 423 423 423 423 423 423 423 423 423 423 423 423 423 423 423 423 423 423 423 423 423 423 423 423 424 161 256 256 256 256 256 256 256 256
161 422 423 423 423 424 161 161 426 417 423 423 423 423 423 423 423 423 423 423 423 423 423 423 423 423 423 423 423 423 423 423 423 423 423 423 423 423 423 416 421 161 256 256 256 256 256 256 256 256
161 422 423 423 423 424 161 161 422 423 423 423 423 423 423 423 423 423 423 423 423 423 423 423 423 423 423 423 423 423 423 423 423 423 423 423 423 423 423 424 159 157 256 256 256 256 256 256 256 256
161 422 423 423 423 424 161 161 422 423 423 423 423 423 423 423 423 423 423 423 423 423 423 423 423 423 423 423 423 423 423 423 423 423 423 423 423 423 423 424 161 256 256 256 256 256 256 256 256 256
161 422 423 423 423 424 161 161 422 423 423 423 423 423 423 423 423 423 423 423 423 423 423 423 423 423 423 423 423 423 423 423 423 423 423 423 423 423 423 424 161 256 256 256 256 256 256 256 256 256
161 422 423 423 423 424 161 161 422 423 423 423 423 423 159 158 158 160 423 423 423 423 423 423 423 423 423 423 423 423 159 158 158 160 423 423 423 423 423 424 161 256 256 256 256 256 256 256 256 256
161 422 423 423 423 424 161 161 422 423 423 423 423 423 161 256 256 161 423 423 423 423 423 423 423 423 423 423 423 423 161 256 256 161 423 423 423 423 423 424 156 160 256 256 256 256 256 256 256 256
161 422 423 423 423 424 161 161 422 423 423 423 423 423 161 256 256 161 423 423 423 423 423 423 423 423 423 423 423 423 161 256 256 161 423 423 423 423 423 418 427 161 256 256 256 256 256 256 256 256
161 422 423 423 423 424 161 161 422 423 423 423 423 423 161 256 256 161 423 423 423 423 423 423 423 423 423 423 423 423 161 256 256 161 423 423 423 423 423 423 424 161 256 256 256 256 256 256 256 256
161 422 423 423 423 424 161 161 422 423 423 423 423 423 161 256 256 158 158 158 158 160 423 423 423 423 159 158 158 158 158 256 256 161 423 423 423 423 423 423 424 161 256 256 256 256 256 256 256 256
161 422 423 423 423 424 161 161 420 415 423 423 423 423 161 256 256 256 256 256 256 161 423 423 423 423 161 256 256 256 256 256 256 161 423 423 423 423 423 423 424 161 256 256 256 256 256 256 256 256
161 422 423 423 423 424 161 156 160 422 423 423 423 423 161 256 256 256 256 256 256 161 423 423 423 423 161 256 256 256 256 256 256 161 423 423 423 423 423 423 424 161 256 256 256 256 256 256 256 256
161 422 423 423 423 424 161 256 161 422 423 423 423 423 156 158 158 158 158 158 158 157 423 423 423 423 156 158 158 158 158 158 158 157 423 423 423 423 423 416 421 161 256 256 256 256 256 256 256 256
161 422 423 423 423 424 156 158 157 422 423 423 423 423 423 423 423 423 423 423 423 423 423 423 423 423 423 423 423 423 423 423 423 423 423 423 423 423 423 424 159 157 256 256 256 256 256 256 256 256
161 422 423 423 423 418 425 425 425 417 423 423 423 423 423 423 423 423 423 423 423 423 423 423 423 423 423 423 423 423 423 423 423 423 423 423 423 423 423 424 161 256 256 256 256 256 256 256 256 256
161 422 423 423 423 423 423 423 423 423 423 423 423 423 423 423 423 423 423 423 423 423 423 423 423 423 423 423 423 423 423 423 423 423 423 423 423 423 423 424 161 256 256 256 256 256 256 256 256 256
161 422 423 423 423 423 423 423 423 423 423 423 423 423 423 423 423 423 423 423 423 423 423 423 423 423 423 423 423 423 423 423 423 423 423 423 423 423 416 421 161 256 256 256 256 256 256 256 256 256
161 420 419 419 419 419 419 419 419 419 419 419 415 423 423 423 423 423 423 423 416 419 419 419 419 415 423 423 423 423 423 423 423 423 423 423 423 423 424 159 157 256 256 256 256 256 256 256 256 256
156 158 158 158 158 158 158 158 158 158 158 160 420 419 419 419 419 419 419 419 421 159 158 158 160 420 419 419 415 423 423 423 423 423 423 423 423 416 421 161 256 256 256 256 256 256 256 256 256 256
256 256 256 256 256 256 256 256 256 256 256 156 158 158 158 158 158 158 158 158 158 157 256 256 156 158 158 160 420 419 419 419 419 419 419 419 419 421 159 157 256 256 256 256 256 256 256 256 256 256
256 256 256 256 256 256 256 256 256 256 256 256 256 256 256 256 256 256 256 256 256 256 256 256 256 256 256 156 158 158 158 158 158 158 158 158 158 158 157 256 256 256 256 256 256 256 256 256 256 256
256 256 256 256 256 256 256 256 256 256 256 256 256 256 256 256 256 256 256 256 256 256 256 256 256 256 256 256 256 256 256 256 256 256 256 256 256 256 256 256 256 256 256 256 256 256 256 256 256 256
256 256 256 256 256 256 256 256 256 256 256 256 256 256 256 256 256 256 256 256 256 256 256 256 256 256 256 256 256 256 256 256 256 256 256 256 256 256 256 256 256 256 256 256 256 256 256 256 256 256
256 256 256 256 256 256 256 256 256 256 256 256 256 256 256 256 256 256 256 256 256 256 256 256 256 256 256 256 256 256 256 256 256 256 256 256 256 256 256 256 256 256 256 256 256 256 256 256 256 256
256 256 256 256 256 256 256 256 256 256 256 256 256 256 256 256 256 256 256 256 256 256 256 256 256 256 256 256 256 256 256 256 256 256 256 256 256 256 256 256 256 256 256 256 256 256 256 256 256 256
256 256 256 256 256 256 256 256 256 256 256 256 256 256 256 256 256 256 256 256 256 256 256 256 256 256 256 256 256 256 256 256 256 256 256 256 256 256 256 256 256 256 256 256 256 256 256 256 256 256
256 256 256 256 256 256 256 256 256 256 256 256 256 256 256 256 256 256 256 256 256 256 256 256 256 256 256 256 256 256 256 256 256 256 256 256 256 256 256 256 256 256 256 256 256 256 256 256 256 256
256 256 256 256 256 256 256 256 256 256 256 256 256 256 256 256 256 256 256 256 256 256 256 256 256 256 256 256 256 256 256 256 256 256 256 256 256 256 256 256 256 256 256 256 256 256 256 256 256 256
256 256 256 256 256 256 256 256 256 256 256 256 256 256 256 256 256 256 256 256 256 256 256 256 256 256 256 256 256 256 256 256 256 256 256 256 256 256 256 256 256 256 256 256 256 256 256 256 256 256
256 256 256 256 256 256 256 256 256 256 256 256 256 256 256 256 256 256 256 256 256 256 256 256 256 256 256 256 256 256 256 256 256 256 256 256 256 256 256 256 256 256 256 256 256 256 256 256 256 256